20.op
....................o.........
...oo..........o..........o...
..oo......oo..................
o....oo...o...................
.o............................
.o......................o.....
..............................
........o..o....o.....o.......
........o..o.........o........
......o..................o....
....o...........o.............
...............oo.............
..............................
.................o............
.....o...o..............o...o.
..........o..............o....
.....o..........o.o...........
.......o..o...................
............o.....o...........
............o.....o...........
